9 9 9 9 9 9 9 9 9 9 9 9 9 9 9 9 9 9 9 9 9 9 9 9 9 9 9 9 9 9 9 9 9 9 9 9 9 9 9 9 9 9 9 9 14 15 15 15 15 15 
9 9 9 9 9 9 9 9 9 9 9 9 9 9 9 9 9 9 9 9 9 9 9 9 9 9 9 9 9 9 9 9 9 9 9 9 9 9 9 9 9 9 9 9 14 15 25 25 25 15 
9 9 14 14 14 14 14 22 22 23 14 14 14 14 14 14 14 14 14 14 14 14 14 14 14 14 14 14 14 14 14 14 14 14 14 9 9 9 9 9 9 9 9 9 14 15 25 25 25 15 
9 9 14 14 14 14 26 23 23 23 23 14 14 14 14 14 14 14 14 14 14 14 14 14 14 14 14 14 14 14 14 14 14 14 14 14 14 28 28 28 9 9 9 9 14 15 25 25 25 15 
9 9 14 14 14 14 22 22 22 26 26 14 14 14 14 14 14 14 14 14 14 14 14 14 14 14 14 14 14 14 14 14 14 14 23 23 23 9 9 28 9 9 9 9 14 15 15 11 15 15 
9 9 26 26 22 22 23 22 26 26 26 14 14 14 14 14 14 14 14 14 14 14 14 14 14 14 14 14 14 14 14 14 14 23 23 9 9 9 23 14 23 9 9 9 14 8 8 8 8 8 
9 9 26 26 22 23 22 26 14 14 14 14 14 14 14 14 14 14 14 14 14 14 14 14 14 14 14 14 14 14 22 22 26 26 9 9 14 22 23 14 23 22 9 9 28 9 9 9 9 9 
9 9 22 26 26 26 26 22 14 14 14 14 14 14 14 14 14 14 14 14 14 14 14 14 14 14 14 23 23 22 22 26 26 9 9 14 26 22 23 14 23 22 26 9 28 9 9 9 9 9 
9 9 26 22 26 26 23 23 23 14 14 14 14 14 14 14 14 14 14 14 14 14 14 14 14 14 14 23 26 22 26 26 9 9 9 14 26 22 23 14 23 22 26 14 14 9 9 9 9 9 
9 9 26 22 22 26 26 23 23 22 14 14 14 14 14 14 14 14 14 14 14 14 14 14 14 14 14 23 22 22 9 9 9 9 14 14 26 22 23 14 23 22 26 14 26 26 22 23 9 9 
9 9 26 26 22 22 26 23 23 22 26 26 14 14 14 14 14 14 14 14 14 14 14 14 14 14 14 26 26 9 9 14 14 14 14 14 26 14 14 14 14 14 26 14 26 26 23 22 9 9 
9 9 22 26 26 26 26 26 23 23 22 26 14 14 14 14 14 14 14 14 14 14 14 14 14 14 9 9 9 9 14 14 14 14 14 14 26 14 14 14 14 14 26 14 23 22 26 22 9 9 
9 9 9 9 9 9 9 9 9 9 9 9 9 9 9 9 9 28 9 9 9 9 9 9 9 9 9 14 14 14 14 14 14 14 14 14 26 14 14 14 14 14 22 14 23 22 23 26 9 9 
9 9 14 9 9 9 9 9 9 9 9 9 9 9 9 9 9 28 9 9 9 9 9 9 14 26 14 14 14 14 14 14 14 14 14 14 23 26 14 14 14 22 22 14 23 22 22 26 9 9 
9 9 26 14 14 14 14 14 14 14 14 14 14 14 14 14 14 14 14 14 14 14 14 14 14 26 14 14 14 14 14 14 14 14 14 14 14 23 14 14 22 22 14 14 26 22 26 22 9 9 
9 9 26 26 14 14 14 14 14 14 22 14 14 14 15 15 15 11 15 15 15 14 14 14 26 26 14 14 14 14 14 14 14 14 14 14 14 26 26 14 22 23 14 26 26 22 26 26 9 9 
9 9 14 26 26 14 14 14 26 22 22 14 14 14 15 25 25 25 25 25 15 14 14 26 26 14 14 14 14 14 14 14 14 14 14 14 14 14 23 14 23 14 14 22 22 14 22 22 9 9 
9 9 14 23 23 26 14 22 22 26 22 26 14 14 15 25 25 25 25 25 15 14 26 26 14 14 14 14 14 14 14 14 14 14 14 14 14 14 23 14 14 14 26 26 26 26 26 26 9 9 
9 9 14 14 22 22 22 23 22 22 26 14 14 14 15 25 25 25 25 25 15 26 26 14 14 14 14 14 14 14 14 14 14 14 14 14 14 14 23 23 23 23 23 23 23 23 23 23 9 9 
9 9 14 22 22 26 22 22 23 14 14 14 26 26 15 15 15 11 15 15 15 26 14 14 14 14 14 14 14 14 14 14 14 14 14 14 14 14 14 14 14 14 14 14 14 14 14 14 9 9 
9 9 14 14 22 22 14 14 14 14 6 29 7 6 6 6 6 8 6 6 6 29 26 26 14 14 14 14 14 14 14 14 14 14 14 14 14 14 14 14 14 14 14 14 14 14 14 14 9 9 
9 9 14 14 14 14 14 14 14 14 6 29 6 6 6 6 6 6 6 6 6 29 29 6 26 14 14 14 14 14 14 14 14 14 14 14 14 14 14 14 14 14 14 14 14 14 14 14 9 9 
9 9 14 14 14 14 14 14 14 14 29 29 6 6 6 6 6 6 6 6 6 6 29 29 26 14 14 14 14 14 14 14 14 14 14 14 14 14 14 14 14 14 14 14 14 14 14 14 9 9 
9 9 14 14 14 14 29 29 29 29 29 6 6 6 6 2 6 6 6 6 6 0 6 29 29 14 14 14 14 14 14 14 14 14 14 14 14 14 14 14 14 14 14 14 14 14 14 14 9 9 
9 9 26 26 14 14 29 5 5 6 6 0 6 6 6 2 2 6 6 2 2 0 6 6 29 14 14 14 14 14 14 14 14 14 14 14 14 14 14 14 14 14 14 14 14 14 14 14 9 9 
9 9 14 26 14 14 29 29 5 4 6 6 0 0 0 0 2 2 0 2 0 6 6 6 29 29 14 14 14 14 14 14 14 14 14 14 14 14 14 14 14 14 14 14 14 14 14 14 9 9 
9 9 14 26 22 26 29 29 5 4 4 4 4 1 1 6 6 2 2 2 6 6 6 6 6 29 29 29 14 14 14 14 14 14 14 14 14 14 14 14 14 14 14 14 14 14 14 14 9 9 
9 9 14 14 14 26 22 22 6 6 1 1 1 1 6 6 0 0 2 2 1 1 4 4 4 4 4 29 29 29 14 14 14 14 14 14 14 14 14 14 14 14 14 14 14 14 14 14 9 9 
9 9 14 14 14 14 14 26 26 6 6 6 6 6 6 6 0 0 1 2 2 2 4 4 4 4 4 6 6 29 14 14 14 14 14 14 14 14 14 14 14 14 14 14 14 14 14 14 9 9 
9 9 14 14 14 14 14 14 14 23 23 14 6 6 6 6 0 0 1 1 2 2 2 4 4 4 4 6 6 29 14 14 14 14 14 14 14 14 14 14 14 14 22 22 14 14 9 9 9 9 
9 9 14 14 14 14 14 14 14 14 23 23 23 26 14 0 0 0 6 1 1 1 1 4 4 4 6 6 6 29 29 14 14 14 14 14 14 14 14 22 22 22 22 26 22 26 9 9 9 9 
9 9 14 14 14 14 14 14 14 14 14 14 23 22 26 6 6 6 6 6 6 1 1 6 6 6 6 6 6 5 6 29 29 29 29 29 29 29 22 22 26 22 26 26 14 14 14 9 9 9 
9 9 14 14 14 14 14 14 14 14 14 14 14 14 22 22 6 6 6 6 6 6 6 6 6 6 6 4 6 5 6 8 29 29 29 29 29 29 14 14 14 14 14 14 14 14 14 9 9 9 
9 9 9 14 14 14 14 14 14 14 14 14 14 14 14 26 6 6 6 6 6 6 6 2 2 6 6 4 6 5 6 29 29 29 0 0 8 14 14 14 14 14 14 14 14 14 14 14 9 9 
9 9 9 9 9 9 14 14 14 14 14 14 14 14 14 14 14 6 6 6 4 4 4 4 4 2 4 4 6 5 5 6 5 5 5 5 6 6 14 14 14 14 14 14 14 14 14 14 14 9 
9 9 9 9 9 9 9 9 14 14 14 14 14 14 14 14 14 14 6 6 6 6 6 6 4 4 4 2 2 5 5 5 5 0 29 29 29 14 14 14 14 14 14 14 14 14 14 14 14 14 
9 9 9 9 9 9 9 9 9 9 9 14 14 14 14 14 14 14 14 6 6 6 6 6 6 0 6 0 2 0 0 5 6 29 29 14 14 14 14 14 23 26 23 23 14 23 26 26 23 23 
9 9 9 9 9 9 9 9 9 9 9 14 14 14 14 14 14 14 14 14 14 26 26 14 6 6 6 6 0 0 5 6 29 29 14 14 14 14 14 23 26 26 23 26 14 23 26 26 26 23 
9 9 9 9 9 9 9 9 9 9 9 9 9 14 14 14 14 14 14 14 14 14 22 22 26 26 22 14 14 29 29 29 29 14 14 14 23 26 23 26 23 23 26 26 14 26 23 26 26 26 
9 9 9 9 9 9 9 9 9 9 9 9 9 9 9 14 14 14 14 14 14 14 14 14 26 22 26 26 14 26 14 14 14 22 14 14 26 23 26 23 26 26 22 22 14 22 23 26 23 23 
9 9 9 9 9 9 9 9 9 9 9 9 9 9 9 9 14 14 14 14 14 14 14 14 14 14 14 26 22 14 14 14 14 22 22 14 23 26 22 22 22 22 22 14 14 22 22 22 22 22 
9 9 9 9 9 9 9 9 9 9 9 9 9 9 9 9 9 9 9 9 9 14 14 14 14 9 14 14 14 14 14 14 14 14 22 22 26 22 14 14 14 14 14 14 14 14 14 14 14 22 
9 9 9 9 9 9 9 9 9 9 9 9 9 9 9 9 9 9 9 9 9 9 9 9 9 9 9 9 9 14 14 14 14 14 14 26 22 22 14 9 9 9 9 9 28 9 9 9 9 9 
9 9 9 9 9 9 9 9 9 9 9 9 9 9 9 9 9 9 9 9 9 9 9 9 9 9 9 9 9 9 9 9 9 9 9 9 9 9 9 9 9 9 9 9 28 9 9 9 9 9 
9 9 9 9 9 9 9 9 9 9 9 9 9 9 9 9 9 9 9 9 9 9 9 9 9 9 9 9 9 9 9 9 9 9 9 9 9 9 9 9 9 9 9 9 28 9 9 9 9 9 
9 9 9 9 9 9 9 9 9 9 9 9 9 9 9 9 9 9 9 9 9 9 9 9 9 9 9 9 9 9 9 9 9 9 9 9 9 9 9 9 9 9 9 9 28 9 9 9 9 9 
9 9 9 9 9 9 9 9 9 9 9 9 9 9 9 9 9 9 9 9 9 9 9 9 9 9 9 9 9 9 9 9 9 9 9 9 9 9 9 9 9 9 9 1 4 4 9 9 9 9 
9 9 9 9 9 9 9 9 9 9 9 9 9 9 9 9 9 9 9 9 9 9 9 9 9 9 9 9 9 9 9 9 9 9 9 9 9 9 9 9 9 9 1 1 4 4 4 1 1 1 
9 9 9 9 9 9 9 9 9 9 9 9 9 9 9 9 9 9 9 9 9 9 9 9 9 9 9 9 9 9 9 9 9 9 9 9 9 9 9 9 9 1 1 1 4 4 4 1 4 4 
9 9 9 9 9 9 9 9 9 9 9 9 9 9 9 9 9 9 9 9 9 9 9 9 9 9 9 9 9 9 9 9 9 9 9 9 9 9 9 9 1 0 0 0 0 0 1 17 4 4 
