10 10 10 10 4 10 10 10 10 10 10 10 10 10 10 10 10 10 10 10 10 4 10 10 10 10 10 10 10 10 10 10 10 10 10 10 10 15 15 15 15 15 15 15 10 10 10 10 10 10
10 10 10 10 4 10 10 10 10 10 10 10 10 10 10 10 10 10 10 10 10 4 10 10 10 10 10 10 10 10 10 10 10 10 10 10 10 15 8 8 8 8 8 15 10 10 10 10 10 10
10 10 10 4 4 10 10 10 10 10 10 10 10 10 10 10 10 10 10 10 10 4 10 10 10 10 10 10 10 10 10 10 10 10 10 10 10 15 8 8 8 8 8 15 10 10 10 10 10 10
10 10 4 4 10 10 10 10 10 10 10 10 10 10 10 10 10 10 10 10 10 4 4 10 10 10 10 10 4 4 4 10 10 10 10 10 10 15 15 15 8 15 15 15 10 10 10 10 10 10
10 4 4 10 10 10 10 10 3 3 3 3 3 5 5 10 10 10 10 10 10 10 3 3 3 3 3 4 4 10 10 10 10 10 10 10 10 15 15 15 8 15 15 15 10 10 10 10 10 10
10 4 10 10 10 10 10 3 3 3 3 5 5 5 5 5 10 10 10 10 10 10 10 4 10 10 10 10 10 10 10 10 10 10 10 10 10 0 3 5 13 5 3 0 10 10 10 10 10 10
3 3 10 10 10 10 10 0 0 9 9 9 9 9 5 5 5 10 10 10 10 10 10 4 10 10 10 10 10 10 10 10 10 10 10 0 10 0 3 5 13 5 3 0 10 10 10 10 10 10
3 3 3 3 3 0 0 0 9 9 9 9 9 9 9 9 5 5 5 5 5 5 5 5 5 5 5 5 10 10 10 10 10 10 0 0 10 0 3 5 13 5 3 0 10 10 10 10 10 10
3 3 9 9 9 9 9 9 9 9 5 5 5 5 9 9 9 9 5 5 5 5 5 5 5 5 5 0 10 10 10 10 10 0 0 0 10 0 3 5 13 5 3 0 10 10 10 10 10 10
9 9 9 9 9 9 9 9 5 5 5 5 5 5 5 9 9 9 9 9 9 9 9 9 9 5 5 0 10 10 10 10 10 0 0 0 10 0 3 5 13 5 3 0 10 10 10 10 10 10
7 7 7 7 7 7 7 5 5 5 5 5 5 5 5 5 5 9 9 9 9 9 9 9 9 9 1 0 0 10 10 10 10 0 0 0 10 10 10 10 13 10 10 10 10 10 10 10 10 10
10 10 10 10 10 10 10 5 5 5 5 10 10 10 10 10 10 10 10 10 10 10 10 10 10 9 1 1 1 1 1 10 0 0 0 0 0 0 5 0 5 0 0 0 0 0 10 10 10 10
10 10 10 10 10 10 10 5 5 1 5 5 5 10 10 10 10 10 10 10 10 10 10 10 10 9 9 9 5 5 1 5 5 5 5 5 5 5 5 5 5 5 0 0 0 10 10 10 10 10
10 10 10 10 10 10 10 5 5 1 5 5 5 5 10 10 10 10 10 10 10 10 10 10 10 10 10 9 9 9 9 9 4 0 0 0 0 0 0 0 0 0 0 0 0 10 10 10 10 10
10 10 10 10 10 10 10 5 5 1 1 5 5 5 10 10 10 10 10 10 10 10 10 10 10 10 10 10 10 10 10 10 4 4 0 0 0 0 3 3 3 3 0 0 10 10 10 10 10 10
10 10 10 10 10 10 10 5 5 1 1 1 5 5 5 5 5 5 10 10 10 10 10 10 10 10 10 10 10 10 10 10 5 5 5 5 5 3 3 3 3 3 3 3 10 10 10 10 10 10
10 10 10 10 10 10 10 5 5 1 5 5 5 5 5 5 5 5 10 10 10 10 10 10 10 10 10 10 10 10 10 10 5 5 5 10 5 5 5 3 3 3 3 3 10 10 10 10 10 10
10 10 10 10 10 10 10 5 5 1 1 5 5 10 10 10 5 5 10 10 10 10 10 10 10 10 10 10 10 10 10 10 10 10 10 10 5 5 5 5 3 3 3 3 10 10 10 10 10 10
10 10 10 10 10 10 10 10 10 5 5 5 5 5 10 10 10 3 10 10 10 10 10 10 10 10 10 10 10 10 10 10 10 10 10 5 5 5 5 5 5 3 3 3 10 10 10 10 10 10
10 10 10 10 10 10 10 10 10 10 10 10 10 10 10 10 10 3 5 10 10 10 10 10 10 10 10 10 10 10 10 10 10 10 10 5 5 5 5 5 5 3 3 3 10 10 10 10 10 10
10 10 10 10 10 10 10 10 10 10 10 10 10 10 10 10 10 3 3 10 10 10 10 10 10 10 10 10 10 10 10 10 10 10 10 5 5 5 5 5 5 3 3 3 3 3 3 10 10 10
10 5 3 10 10 10 10 10 10 10 10 10 10 10 10 10 10 5 3 5 10 10 10 10 10 10 10 10 10 10 10 10 10 10 10 5 5 5 5 5 5 5 3 3 3 3 3 10 10 10
10 3 3 10 10 10 10 10 10 10 10 10 10 10 10 10 3 5 5 1 5 5 5 10 10 10 10 10 10 10 10 10 10 10 10 5 5 5 5 5 5 5 5 3 3 3 6 10 10 10
10 5 3 10 10 10 10 10 10 10 10 10 10 10 10 5 5 5 1 1 5 5 5 5 15 15 15 15 15 15 10 10 10 10 10 10 5 5 5 5 5 5 5 10 10 10 6 6 10 10
10 10 5 5 5 10 10 10 10 10 10 10 10 10 10 3 10 5 1 1 5 5 5 5 15 6 6 6 6 15 10 6 6 10 10 10 10 10 10 10 10 10 10 10 10 10 10 6 10 10
10 10 10 10 5 5 5 10 10 10 10 10 10 5 3 3 10 5 5 1 1 1 5 5 6 6 6 6 6 6 6 6 6 6 6 6 6 10 10 10 10 10 10 10 10 10 10 6 10 10
10 10 10 2 2 10 5 5 5 5 5 5 5 5 10 10 10 5 5 5 1 1 5 5 15 6 6 6 6 15 10 10 10 10 6 10 10 10 10 10 10 10 10 10 6 6 6 6 10 10
10 10 10 2 10 10 10 10 10 10 10 10 10 10 10 10 10 10 10 10 10 5 10 10 15 15 15 15 15 15 10 10 10 10 6 10 10 10 10 10 10 10 6 6 6 10 10 10 10 10
10 10 2 2 10 10 10 10 10 10 10 10 10 10 10 10 10 10 10 10 10 5 10 10 10 10 10 10 10 10 10 10 10 10 6 6 10 10 10 10 10 10 6 10 10 10 10 10 10 10
10 10 2 10 10 10 10 10 10 10 10 10 10 10 10 10 10 10 10 10 10 5 10 10 10 10 10 10 10 10 10 10 10 10 10 6 6 10 10 10 10 10 6 6 10 10 10 10 10 10
10 10 4 10 10 10 10 10 10 10 10 10 10 10 10 10 10 10 10 10 10 5 10 10 10 10 10 10 10 10 10 10 10 10 10 6 6 10 10 10 10 10 10 6 10 10 10 10 10 10
10 10 4 10 10 10 10 10 10 10 10 10 10 10 10 10 10 10 10 10 10 5 10 10 10 10 10 10 10 10 10 10 10 10 10 6 6 10 10 10 10 10 10 6 10 10 10 10 10 10
10 4 4 10 10 10 10 10 10 10 10 10 10 10 10 10 10 10 10 10 10 5 5 10 10 10 10 10 10 10 10 10 10 10 10 6 6 6 10 10 10 10 6 6 10 10 10 10 10 10
10 5 3 10 10 10 10 4 10 10 10 10 10 10 10 10 10 10 10 10 10 10 5 5 5 5 5 5 10 10 10 10 10 10 10 6 6 6 6 6 6 6 6 10 10 10 10 10 10 10
4 5 5 5 4 4 4 4 4 4 4 4 10 10 10 10 10 10 10 10 10 10 10 10 10 10 10 5 10 10 10 10 10 10 10 10 10 10 10 10 10 10 10 10 10 10 10 10 10 10
10 10 10 5 5 4 10 10 10 4 4 4 10 10 10 10 10 10 10 10 10 10 10 10 10 10 10 5 10 10 10 10 10 10 10 10 10 10 10 10 10 10 10 10 10 10 10 10 10 10
10 10 10 10 10 10 10 10 10 4 4 4 4 10 10 10 10 10 10 10 10 10 10 10 10 10 10 5 5 5 10 10 10 10 10 10 10 4 4 4 10 10 10 10 10 10 10 10 10 10
10 10 10 10 10 10 10 10 10 10 4 4 4 10 10 10 4 4 4 10 10 10 10 10 10 10 10 10 5 5 10 10 10 10 10 10 4 4 10 4 10 10 10 10 10 10 10 10 10 10
10 10 10 10 10 10 10 10 10 10 10 4 4 4 10 10 4 4 4 10 10 10 10 10 10 10 10 10 10 10 10 10 10 10 10 4 4 10 10 4 4 10 10 10 10 10 10 10 10 10
10 10 10 10 10 10 10 10 10 10 10 10 4 4 4 4 4 4 4 4 10 10 10 10 10 10 10 10 10 10 10 10 10 10 10 4 10 10 10 4 4 10 10 10 10 10 10 10 10 10
10 10 10 10 10 10 10 10 10 10 10 10 10 4 4 4 4 4 4 4 4 4 4 4 10 10 10 10 10 10 10 10 10 10 10 4 10 10 10 4 4 4 10 10 10 10 10 10 10 10
10 10 10 10 10 10 10 10 10 10 10 10 10 10 10 10 10 10 10 10 4 4 4 4 4 4 4 4 4 4 4 4 4 4 4 4 10 10 10 10 10 10 10 10 10 10 10 10 10 10
10 10 10 10 10 10 10 10 10 10 10 10 10 10 10 10 10 10 10 10 10 10 10 10 10 4 4 4 4 4 4 4 4 4 4 10 10 10 10 10 10 10 10 10 10 10 10 10 10 10
10 10 10 10 10 10 10 10 10 10 6 6 9 9 9 9 9 10 10 10 10 10 10 10 10 4 4 4 4 4 4 4 4 4 10 10 10 10 10 10 10 10 10 10 10 10 10 10 10 10
6 6 6 6 6 6 6 6 6 6 6 9 9 6 6 6 9 9 10 10 10 10 10 10 10 4 4 4 4 4 4 4 4 4 10 10 10 10 10 10 10 10 10 10 10 10 10 10 10 10
6 8 8 8 8 8 8 6 6 6 9 9 6 6 6 6 6 9 9 10 10 10 10 10 10 4 4 4 4 4 4 4 4 4 10 4 4 4 10 10 10 10 10 10 10 10 10 10 10 10
9 9 9 9 9 9 9 9 9 9 9 6 6 6 6 6 6 6 9 10 10 10 10 10 10 4 4 4 4 4 4 4 4 4 4 4 10 4 4 10 10 10 10 10 10 10 10 10 10 10
6 8 8 8 8 8 8 8 6 6 6 6 6 6 6 6 6 6 9 9 9 9 6 6 4 4 10 10 10 10 10 10 10 10 10 10 10 10 4 4 10 10 10 10 10 10 10 10 10 10
6 6 17 8 8 8 8 8 6 6 6 6 6 6 6 6 6 6 6 6 6 6 6 6 6 10 10 10 10 10 10 10 10 10 10 10 10 10 10 4 4 10 10 10 10 10 10 10 10 10
6 6 6 6 6 6 6 6 6 6 6 6 6 6 6 6 10 10 10 10 10 10 10 10 10 10 10 10 10 10 10 10 10 10 10 10 10 10 10 10 4 4 10 10 10 10 10 10 10 10
