29 29 29 29 29 29 29 29 29 29 29 29 29 29 29 29 29 29 29 29 29 4 29 29 29 29 29 29 29 29 29 29 29 29 29 29 29 30 30 30 30 30 30 30 29 29 29 29 29 29 
29 29 29 29 4 29 29 29 29 29 29 29 29 29 29 29 29 29 29 29 29 4 29 29 29 29 29 29 29 29 29 29 29 29 29 29 29 30 36 25 25 25 25 30 29 29 29 29 29 29 
29 29 29 4 4 29 29 29 29 29 29 29 29 29 29 29 29 29 29 29 29 4 29 29 29 29 29 29 29 29 29 29 29 29 29 29 29 30 25 25 25 25 25 30 29 29 29 29 29 29 
29 29 4 4 29 29 29 29 29 29 29 29 29 29 29 29 29 29 29 29 29 4 4 29 29 29 29 29 4 4 4 29 29 29 29 29 29 30 25 25 25 25 25 30 29 29 29 29 29 29 
29 4 4 29 29 29 29 29 3 3 3 3 3 5 5 29 29 29 29 29 29 29 3 3 3 3 3 4 4 29 29 29 29 29 29 29 29 30 30 30 25 30 30 30 29 29 29 29 29 29 
29 4 29 29 29 29 29 3 3 3 3 5 5 5 5 5 29 29 29 29 29 29 29 4 29 29 29 29 29 29 29 29 29 29 29 29 29 0 3 5 13 5 3 0 29 29 29 29 29 29 
29 3 29 29 29 29 29 0 0 9 9 9 9 9 5 5 5 29 29 29 29 29 29 4 29 29 29 29 29 29 29 29 29 29 29 0 29 0 3 5 13 5 3 0 29 29 29 29 29 29 
29 3 3 3 3 0 0 0 9 9 9 9 9 9 9 9 5 5 5 5 5 5 5 5 5 5 5 5 29 29 29 29 29 29 0 0 29 0 3 5 13 5 3 0 29 29 29 29 29 29 
29 3 9 9 9 9 9 9 9 9 5 5 5 5 9 9 9 9 5 5 5 5 5 5 5 5 5 0 29 29 29 29 29 0 0 0 29 3 3 5 13 5 3 0 29 29 29 29 29 29 
9 9 9 9 9 9 9 9 5 5 5 5 5 5 5 9 9 9 9 9 9 9 9 9 9 5 5 0 29 29 29 29 29 0 0 0 29 3 3 5 13 5 3 0 29 29 29 29 29 29 
29 7 7 7 7 7 7 5 5 5 5 5 5 5 5 5 5 9 9 9 9 9 9 9 9 9 1 0 0 29 29 29 29 0 0 0 29 29 29 29 11 29 29 29 29 29 29 29 29 29 
29 29 29 29 29 29 29 5 5 5 5 29 29 29 29 29 29 29 29 29 29 29 29 29 29 9 1 1 1 1 1 29 0 0 0 0 0 0 5 0 5 0 0 4 0 0 29 29 29 29 
29 29 29 29 29 29 29 5 5 1 5 5 5 29 29 29 29 29 29 29 29 29 29 29 29 9 9 9 5 5 1 5 5 5 5 5 5 5 5 5 5 5 0 0 0 29 29 29 29 29 
29 29 29 29 29 29 29 5 5 1 5 5 5 5 29 29 29 29 29 29 29 29 29 29 29 29 29 9 9 9 9 9 4 0 0 0 0 0 0 0 0 0 0 0 0 29 29 29 29 29 
29 29 29 29 29 29 29 5 5 1 33 5 5 5 29 29 29 29 29 29 29 29 29 29 29 29 29 29 29 29 29 29 4 4 0 0 0 0 3 33 3 3 0 0 29 29 29 29 29 29 
29 29 29 29 29 29 29 5 5 1 1 1 5 5 5 5 5 5 29 29 29 29 29 29 29 29 29 29 29 29 29 29 5 5 5 5 5 3 3 3 3 3 3 3 29 29 29 29 29 29 
29 29 29 29 29 29 29 5 5 1 5 5 5 5 5 5 5 5 29 29 29 29 29 29 29 29 29 29 29 29 29 29 5 5 5 29 5 5 5 3 3 3 3 3 29 29 29 29 29 29 
29 29 29 29 29 29 29 5 5 1 1 5 5 29 29 29 5 5 29 29 29 29 29 29 29 29 29 29 29 29 29 29 29 29 29 29 5 5 5 5 3 3 3 3 29 29 29 29 29 29 
29 29 29 29 29 29 29 29 29 5 5 5 5 5 29 29 29 3 29 29 29 29 29 29 29 29 29 29 29 29 29 29 29 29 29 5 5 5 5 5 5 3 3 3 29 29 29 29 29 29 
29 29 29 29 29 29 29 29 29 29 29 29 29 29 29 29 29 3 5 29 29 29 29 29 29 29 29 29 29 29 29 29 29 29 29 5 5 5 5 5 5 3 3 3 29 29 29 29 29 29 
29 29 29 29 29 29 29 29 29 29 29 29 29 29 29 29 29 3 3 29 29 29 29 29 29 29 29 29 29 29 29 29 29 29 29 5 5 5 5 5 5 3 3 3 3 3 3 29 29 29 
29 5 3 29 29 29 29 29 29 29 29 29 29 29 29 29 29 5 3 5 29 29 29 29 29 29 29 29 29 29 29 29 29 29 29 5 5 5 5 5 5 5 3 3 3 3 3 29 29 29 
29 3 3 29 29 29 29 29 29 29 29 29 29 29 29 29 3 5 5 1 5 5 5 29 29 29 29 29 29 29 29 29 29 29 29 5 5 5 5 5 5 5 5 3 3 3 6 29 29 29 
29 5 3 29 29 29 29 29 29 29 29 29 29 29 29 5 5 5 1 1 5 5 5 5 30 30 30 30 30 30 29 29 29 29 29 29 5 5 5 5 5 5 5 29 29 29 6 6 29 29 
29 29 5 5 5 29 29 29 29 29 29 29 29 29 29 3 29 5 1 1 5 5 5 5 30 25 25 25 25 30 29 6 6 29 29 29 29 29 29 29 29 29 29 29 29 29 29 6 29 29 
29 29 29 29 5 5 5 29 29 29 29 29 29 5 3 3 29 5 5 1 1 1 5 5 6 25 25 25 25 6 6 6 6 6 6 6 6 29 29 29 29 29 29 29 29 29 29 6 29 29 
29 29 29 2 2 29 5 5 5 5 5 5 5 5 29 29 29 5 5 5 1 1 5 5 30 25 25 25 25 30 29 29 29 29 6 6 6 6 6 29 29 29 29 29 6 6 6 6 29 29 
29 29 29 2 29 29 29 29 29 29 29 29 29 29 29 29 29 29 29 29 29 5 29 29 30 30 30 30 30 30 29 29 29 29 6 6 6 6 6 29 29 29 6 6 6 29 29 29 29 29 
29 29 2 2 29 29 29 29 29 29 29 29 29 29 29 29 29 29 29 29 29 5 29 29 29 29 29 29 29 29 29 29 29 29 6 6 6 6 6 29 29 29 6 6 29 29 29 29 29 29 
29 29 2 29 29 29 29 29 29 29 29 29 29 29 29 29 29 29 29 29 29 5 29 29 29 29 29 29 29 29 29 29 29 29 6 6 6 6 6 29 29 29 6 6 29 29 29 29 29 29 
29 29 4 29 29 29 29 29 29 29 29 29 29 29 29 29 29 29 29 29 29 5 29 29 29 29 29 29 29 29 29 29 29 29 29 6 6 6 6 6 6 6 6 6 29 29 29 29 29 29 
29 29 4 29 29 29 29 29 29 29 29 29 29 29 29 29 29 29 29 29 29 5 29 29 29 29 29 29 29 29 29 29 29 29 29 6 6 6 6 6 6 6 6 6 29 29 29 29 29 29 
29 4 4 29 29 29 29 29 29 29 29 29 29 29 29 29 29 29 29 29 29 5 5 29 29 29 29 29 29 29 29 29 29 29 29 6 6 6 6 6 6 6 6 6 29 29 29 29 29 29 
29 5 3 29 29 29 29 4 29 29 29 29 29 29 29 29 29 29 29 29 29 29 5 5 5 5 5 5 29 29 29 29 29 29 29 6 6 6 6 6 6 6 6 29 29 29 29 29 29 29 
29 5 5 5 4 4 4 4 4 4 4 4 29 29 29 29 29 29 29 29 29 29 29 29 29 29 29 5 29 29 29 29 29 29 29 29 29 29 29 29 29 29 29 29 29 29 29 29 29 29 
29 29 29 5 5 4 29 29 29 4 4 4 29 29 29 29 29 29 29 29 29 29 29 29 29 29 29 5 29 29 29 29 29 29 29 29 29 29 29 29 29 29 29 29 29 29 29 29 29 29 
29 29 29 29 29 29 29 29 29 4 4 4 4 29 29 29 29 29 29 29 29 29 29 29 29 29 29 5 5 5 29 29 29 29 29 29 29 4 4 4 29 29 29 29 29 29 29 29 29 29 
29 29 29 29 29 29 29 29 29 29 4 4 4 29 29 29 4 4 4 29 29 29 29 29 29 29 29 29 5 5 29 29 29 29 29 29 4 4 29 4 29 29 29 29 29 29 29 29 29 29 
29 29 29 29 29 29 29 29 29 29 29 4 4 4 29 29 4 4 4 29 29 29 29 29 29 29 29 29 29 29 29 29 29 29 29 4 4 29 29 4 4 29 29 29 29 29 29 29 29 29 
29 29 29 29 29 29 29 29 29 29 29 29 4 4 4 4 4 4 4 4 29 29 29 29 29 29 29 29 29 29 29 29 29 29 29 4 29 29 29 4 4 29 29 29 29 29 29 29 29 29 
29 29 29 29 29 29 29 29 29 29 29 29 29 4 4 4 4 4 4 4 4 4 4 4 29 29 29 29 29 29 29 29 29 29 29 4 29 29 29 4 4 4 29 29 29 29 29 29 29 29 
29 29 29 29 29 29 29 29 29 29 29 29 29 29 29 29 29 29 29 29 4 4 4 4 4 4 4 4 4 5 4 4 4 4 4 4 29 29 29 29 29 29 29 29 29 29 29 29 29 29 
29 29 29 29 29 29 29 29 29 29 29 29 29 29 29 29 29 29 29 29 29 29 29 29 29 4 4 4 4 4 4 4 4 4 4 29 29 29 29 29 29 29 29 29 29 29 29 29 29 29 
29 29 29 29 29 29 29 29 29 29 6 6 9 9 9 9 9 29 29 29 29 29 29 29 29 4 4 4 4 4 4 4 4 4 29 29 29 29 29 29 29 29 29 29 29 29 29 29 29 29 
29 6 6 6 6 6 6 6 6 6 6 9 9 6 6 6 9 9 29 29 29 29 29 29 29 4 4 4 4 4 4 4 4 4 29 29 29 29 29 29 29 29 29 29 29 29 29 29 29 29 
38 8 8 8 8 8 8 6 6 6 9 9 6 6 6 6 6 9 9 29 29 29 29 29 29 4 4 4 4 4 4 4 4 4 29 4 4 4 29 29 29 29 29 29 29 29 29 29 29 29 
9 9 9 9 9 9 9 28 9 9 9 6 6 6 6 6 6 6 9 29 29 29 29 29 29 4 4 4 4 4 4 4 4 4 4 4 29 4 4 29 29 29 29 29 29 29 29 29 29 29 
9 8 8 8 8 8 8 8 6 6 6 6 6 6 6 6 6 6 9 9 9 9 6 6 4 4 29 29 29 29 29 29 29 29 29 29 29 29 4 4 29 29 29 29 29 29 29 29 29 29 
9 6 7 8 8 8 8 8 6 6 6 6 6 6 6 6 6 6 6 6 6 6 6 6 6 29 29 29 29 29 29 29 29 29 29 29 29 29 29 4 4 29 29 29 29 29 29 29 29 29 
29 29 29 29 29 29 29 29 29 29 29 29 29 29 29 29 29 29 29 29 29 29 29 29 29 29 29 29 29 29 29 29 29 29 29 29 29 29 29 29 29 29 29 29 29 29 29 29 29 29 
