15 15 15 15 15 15 15 15 15 15 15 15 15 15 15 15 15 15 15 15 15 15 15 15 15 15 15 15 15 15 15 15 15 15 15 15 15 15 15 15 15 15 15 15 15 15 15 15 15 15 
15 0 0 0 0 0 0 0 0 0 0 0 0 0 0 0 0 0 0 0 0 0 0 0 0 0 0 0 0 0 0 0 0 0 0 0 0 0 0 0 0 0 0 0 0 0 0 0 0 15 
15 0 0 5 0 0 5 5 0 5 5 0 0 0 0 9 0 0 0 5 0 0 0 5 0 0 0 0 0 0 0 0 0 0 0 0 0 0 0 0 0 0 0 0 0 0 0 0 0 15 
15 0 0 0 0 0 0 0 0 0 0 0 5 5 5 9 5 0 5 5 0 0 0 0 0 0 5 5 0 0 0 0 0 0 0 0 0 0 0 0 0 0 0 0 0 0 0 0 0 15 
15 0 0 0 2 2 2 0 0 0 0 0 0 0 0 9 0 0 0 0 0 0 0 0 0 0 0 5 0 0 0 0 0 0 0 0 0 0 0 0 0 0 0 0 0 0 0 0 0 15 
15 0 0 2 0 0 0 2 2 0 0 0 0 0 0 9 9 0 0 0 0 0 0 0 0 0 0 0 0 15 15 15 0 0 0 0 0 0 0 0 0 0 0 0 0 0 0 0 0 15 
15 0 0 2 2 0 2 6 6 0 0 0 0 0 0 0 9 9 0 0 0 0 0 5 0 0 0 0 0 0 0 15 15 0 0 0 0 0 0 0 0 0 0 0 0 0 0 0 0 15 
15 0 0 0 2 0 6 6 2 6 0 0 0 0 0 5 0 9 9 9 0 0 0 0 0 0 0 15 0 0 0 0 15 15 15 0 0 0 0 0 0 0 0 0 0 0 0 0 0 15 
15 0 0 0 0 0 6 6 6 0 0 0 0 0 0 0 0 0 0 9 9 0 0 0 0 0 0 15 0 0 0 0 0 0 15 15 0 0 0 0 0 0 0 0 0 0 0 0 0 15 
15 0 0 0 2 0 2 6 6 0 0 0 0 0 0 0 0 0 0 0 9 9 9 0 0 0 0 15 15 0 0 0 0 0 0 15 15 15 0 0 0 0 0 0 0 0 0 0 0 15 
15 0 0 2 2 0 0 0 0 0 0 0 0 5 0 0 0 0 0 0 9 9 9 9 0 0 0 0 15 15 0 0 0 0 0 0 0 15 15 0 0 0 0 0 0 0 0 0 0 15 
15 0 0 2 0 0 0 0 0 0 0 5 5 5 0 0 0 5 5 5 9 10 10 9 0 0 5 5 0 15 15 0 0 0 0 0 0 0 15 15 15 0 0 0 0 0 0 0 0 15 
15 0 0 0 2 15 15 15 15 15 5 5 0 0 0 0 0 5 5 5 9 10 10 9 0 0 5 0 0 0 15 15 15 0 0 0 0 0 0 0 15 15 0 0 0 0 0 0 0 15 
15 0 0 0 0 15 16 14 14 15 5 0 0 0 0 0 0 5 5 0 9 9 9 9 0 0 0 0 0 0 0 0 15 15 0 0 0 0 0 0 0 15 15 0 0 0 0 0 0 15 
15 0 0 0 0 15 14 14 14 15 0 0 0 0 0 0 0 5 5 5 5 0 0 9 0 0 0 0 0 0 0 0 0 15 15 15 0 0 0 0 0 0 15 0 0 0 0 0 0 15 
15 0 0 0 0 15 14 14 14 15 0 0 0 0 0 0 0 5 5 5 5 0 0 9 9 9 9 0 0 0 0 0 0 0 0 15 15 0 0 0 0 0 15 0 0 0 0 0 0 15 
15 0 0 0 0 15 15 14 15 15 0 0 0 0 0 0 0 0 5 5 0 0 0 0 0 0 9 9 0 0 0 0 0 0 0 0 15 0 0 0 0 0 15 0 0 0 0 0 0 15 
15 0 0 0 0 0 0 0 5 5 0 0 0 0 0 0 0 5 0 0 0 0 0 0 0 0 0 9 0 0 0 0 0 0 0 0 15 15 15 15 15 15 15 0 0 0 0 0 0 15 
15 0 0 0 0 0 0 0 0 0 0 0 0 0 0 0 13 13 13 13 0 0 0 0 0 0 0 0 0 0 0 0 0 0 0 0 0 0 0 0 0 0 0 0 0 0 0 0 0 15 
15 0 0 0 0 0 0 0 0 0 0 0 0 0 0 0 13 19 20 13 0 0 0 0 0 0 0 0 0 0 0 0 0 0 0 0 0 0 0 5 5 5 5 0 0 0 0 0 0 15 
15 0 0 0 5 0 0 0 0 0 5 5 5 0 0 0 13 13 13 13 0 0 0 0 0 0 0 0 0 0 0 0 0 0 0 0 0 0 0 0 0 0 0 0 0 0 0 0 0 15 
15 0 0 5 5 5 5 5 5 0 0 5 0 0 0 0 0 0 0 0 0 0 0 0 0 0 0 0 0 0 5 5 5 0 5 0 0 0 0 0 0 0 0 0 0 0 0 0 0 15 
15 0 0 0 5 0 0 5 5 0 0 0 0 0 0 0 0 0 5 0 0 0 0 0 0 0 0 0 0 5 5 0 5 5 5 0 0 0 0 0 0 0 0 0 0 0 0 0 0 15 
15 0 0 0 5 0 0 0 5 0 5 0 5 5 5 0 0 5 5 0 0 5 5 5 5 0 0 0 0 5 5 5 5 5 0 0 0 0 0 0 0 0 0 13 13 13 13 13 13 15 
15 0 0 0 5 0 0 0 5 0 5 0 0 0 5 5 5 0 0 0 0 0 0 0 0 0 0 0 0 0 0 0 5 5 0 0 0 0 0 0 0 0 13 13 13 13 13 13 13 15 
15 0 0 0 0 5 5 0 5 5 5 0 0 0 0 0 0 0 0 0 0 0 0 0 0 0 0 0 0 0 0 0 5 0 0 0 0 0 0 0 13 13 13 0 0 0 0 0 0 15 
15 0 0 0 0 5 0 5 5 5 0 0 5 0 0 0 0 0 0 0 0 0 0 0 0 0 5 5 5 0 0 0 0 0 0 0 0 0 0 13 13 13 0 0 0 0 0 0 0 15 
15 0 0 0 0 5 0 5 0 5 0 0 0 5 0 0 0 0 7 7 7 7 7 8 8 8 0 0 0 0 0 0 0 0 0 0 0 13 13 13 13 13 0 0 0 5 5 5 0 15 
15 0 0 0 5 5 5 5 5 5 0 0 0 5 5 0 0 8 8 7 7 6 7 7 7 8 0 0 0 0 0 0 0 0 0 0 13 13 13 13 13 0 0 0 0 5 5 5 0 15 
15 0 0 0 5 5 5 0 5 0 0 0 0 0 0 5 8 5 8 8 7 6 6 6 8 7 0 0 0 0 0 0 0 13 13 13 13 13 13 13 13 0 0 0 5 5 0 0 0 15 
15 0 0 0 15 15 15 15 15 0 0 0 0 0 0 0 8 8 8 7 8 8 6 6 6 7 0 0 0 0 0 0 0 13 13 13 13 13 13 13 0 0 0 0 5 5 5 0 0 15 
15 0 0 0 15 0 3 3 15 15 15 0 0 0 0 0 8 8 0 8 8 8 8 8 8 7 0 0 0 0 0 0 0 13 13 13 13 13 0 0 0 0 0 0 0 0 0 0 0 15 
15 0 0 0 15 0 0 0 0 0 15 0 0 0 0 0 8 8 6 8 8 8 8 8 8 7 0 0 0 5 5 0 0 0 13 0 0 0 0 0 0 0 0 0 0 0 0 0 0 15 
15 0 0 0 15 0 0 0 0 0 15 15 0 0 0 0 0 0 6 8 8 8 8 8 8 8 0 0 0 0 5 0 0 0 0 0 0 0 0 0 0 14 14 14 14 14 14 14 14 15 
15 0 0 0 15 0 0 0 0 0 0 15 0 0 0 0 0 0 0 0 0 0 0 0 0 0 0 0 0 0 0 5 0 0 0 0 0 0 0 14 14 14 14 14 14 14 14 14 14 15 
15 0 0 0 15 0 0 0 0 0 0 15 15 0 0 0 0 0 0 0 0 0 0 0 0 0 0 0 0 0 0 0 0 0 0 0 0 14 14 14 14 14 14 14 14 14 9 9 9 15 
15 0 0 0 15 15 0 0 0 0 0 0 15 0 0 0 0 0 0 0 0 0 0 0 0 0 0 0 0 0 0 0 0 0 0 14 14 14 14 14 14 14 14 14 14 9 9 9 9 15 
15 0 0 0 0 15 15 15 15 0 0 0 15 0 0 0 0 0 0 0 0 0 0 0 0 0 0 0 0 0 0 0 0 0 0 14 14 14 14 14 14 14 14 14 9 9 9 9 9 15 
15 0 0 0 0 0 0 0 15 15 0 15 15 0 0 0 0 0 0 0 0 0 0 0 0 0 0 0 0 0 0 0 0 0 14 14 14 14 14 14 14 14 14 9 9 9 9 9 9 15 
15 0 0 0 0 0 0 0 0 0 0 0 0 0 0 0 0 0 0 0 0 0 0 0 0 0 0 0 0 0 0 0 0 14 14 14 14 14 14 14 14 14 9 9 9 9 9 9 9 15 
15 0 0 0 0 0 0 0 0 0 0 0 0 0 0 0 0 0 0 0 0 0 0 0 0 0 0 0 0 0 0 0 0 14 14 14 14 14 14 14 14 9 9 9 9 9 9 9 9 15 
15 0 0 0 0 0 0 0 0 0 0 0 15 0 0 15 1 0 0 0 0 0 0 0 0 0 0 0 0 0 0 0 14 14 14 14 14 14 14 14 9 9 9 9 9 9 9 9 9 15 
15 0 0 0 0 0 15 15 15 15 15 15 15 21 21 15 15 15 15 15 15 15 0 0 0 0 0 0 0 0 0 14 14 14 14 14 14 14 14 14 9 9 9 9 9 9 9 9 9 15 
15 0 0 0 0 0 15 11 11 11 11 11 11 11 11 11 11 11 11 11 11 15 0 0 0 0 0 0 0 0 0 14 14 14 14 14 14 14 14 9 9 9 9 9 9 9 9 9 9 15 
15 0 0 0 0 0 15 11 11 11 11 11 11 11 11 11 11 11 11 11 11 15 0 0 0 0 0 0 0 0 0 14 14 14 14 14 14 14 9 9 9 9 9 9 9 9 9 9 9 15 
15 0 0 0 0 0 15 11 11 11 11 11 11 11 11 11 11 11 11 11 11 15 0 0 0 0 0 0 0 0 14 14 14 14 14 14 14 9 9 9 9 9 9 9 9 9 9 9 9 15 
15 0 0 0 0 0 15 11 11 11 11 11 11 11 11 11 11 11 11 11 11 15 0 0 0 0 0 0 0 0 14 14 14 14 14 14 9 9 9 9 9 9 9 9 9 9 9 9 9 15 
15 0 0 0 0 0 15 11 11 11 11 11 11 11 11 11 11 11 11 11 11 15 0 0 0 0 0 0 0 14 14 14 14 14 14 14 9 9 9 9 9 9 9 9 9 9 9 9 9 15 
15 0 0 0 0 0 15 11 11 11 11 11 11 11 11 11 11 11 11 11 11 15 0 0 0 0 0 0 0 14 14 14 14 14 14 9 9 9 9 9 9 9 9 9 9 9 9 9 9 15 
15 15 15 15 15 15 15 15 15 15 15 15 15 15 15 15 15 15 15 15 15 15 15 15 15 15 15 15 15 15 15 15 15 15 15 15 15 15 15 15 15 15 15 15 15 15 15 15 15 15 
